SOA,SOA Code,All usual residents in households,"NS0SeC of HRP: 1. Higher managerial, administrative and professional occupations",NS0SeC of HRP: 1.1 Large employers and higher managerial and administrative occupations,NS0SeC of HRP: 1.2 Higher professional occupations,"NS0SeC of HRP: 2. Lower managerial, administrative and professional occupations",NS0SeC of HRP: 3. Intermediate occupations,NS0SeC of HRP: 4. Small employers and own account workers,NS0SeC of HRP: 5. Lower supervisory and technical occupations,NS0SeC of HRP: 6. Semi0routine occupations,NS0SeC of HRP: 7. Routine occupations,NS0SeC of HRP: 8. Never worked and long0term unemployed,NS0SeC of HRP: L14.1 Never worked,NS0SeC of HRP: L14.2 Long0term unemployed,NS0SeC of HRP: Not classified: L15 Full0time students
Aldergrove 1,95AA01S1,982,98,51,47,464,234,35,80,39,25,0,0,0,7
Aldergrove 2,95AA01S2,1814,256,40,216,417,170,446,162,156,156,47,34,13,4
Aldergrove 3,95AA01S3,1494,226,52,174,399,176,294,86,114,159,30,19,11,10
Balloo,95AA02W1,1734,76,13,63,326,216,112,251,296,383,68,34,34,6
Ballycraigy,95AA03W1,1822,67,22,45,244,231,94,239,407,427,106,70,36,7
Clady,95AA04W1,3002,365,109,256,727,274,837,271,200,254,53,30,23,21
Cranfield,95AA05W1,2654,283,68,215,615,288,524,272,264,323,66,42,24,19
Crumlin 1 (Antrim LGD),95AA06S1,1953,142,52,90,441,287,270,175,296,237,87,49,38,18
Crumlin 2 (Antrim LGD),95AA06S2,2651,194,69,125,687,376,323,226,370,337,106,63,43,32
Drumanaway,95AA07W1,2119,197,47,150,395,209,461,168,249,365,68,40,28,7
Farranshane,95AA08W1,1676,38,13,25,247,236,90,198,296,426,131,78,53,14
Fountain Hill,95AA09W1,2143,151,22,129,357,253,142,212,507,411,90,65,25,20
Greystone (Antrim LGD),95AA10W1,1953,149,46,103,373,214,151,217,322,380,135,105,30,12
Massereene 1,95AA11S1,2698,214,46,168,671,350,303,273,353,447,71,46,25,16
Massereene 2,95AA11S2,2431,278,71,207,676,363,251,260,317,234,43,28,15,9
Parkgate,95AA12W1,2775,454,133,321,755,347,628,219,139,190,43,28,15,0
Randalstown 1,95AA13S1,1707,232,47,185,372,200,233,143,200,254,48,34,14,25
Randalstown 2,95AA13S2,1561,175,62,113,364,192,196,119,196,246,66,37,29,7
Shilvodan,95AA14W1,2302,330,81,249,530,248,573,163,184,193,74,57,17,7
Springfarm 1,95AA15S1,2630,205,36,169,685,373,214,282,387,425,54,28,26,5
Springfarm 2,95AA15S2,1472,76,14,62,298,199,86,161,227,305,99,65,34,21
Steeple,95AA16W1,1807,62,12,50,240,212,112,236,381,448,96,56,40,20
Stiles,95AA17W1,2142,158,53,105,410,222,196,204,374,460,108,64,44,10
Templepatrick,95AA18W1,2373,474,78,396,696,289,465,118,172,113,41,36,5,5
Toome,95AA19W1,2645,162,44,118,435,207,710,229,294,421,179,154,25,8
Ballygowan 1,95BB01S1,1574,204,73,131,380,166,342,124,151,178,27,14,13,2
Ballygowan 2,95BB01S2,2035,246,57,189,410,331,313,225,225,234,33,12,21,18
Ballyrainey,95BB02W1,2334,133,50,83,357,263,281,226,443,472,150,79,71,9
Ballywalter 1,95BB03S1,2026,135,25,110,350,280,226,262,345,318,100,57,43,10
Ballywalter 2,95BB03S2,2191,198,46,152,449,248,480,179,305,257,59,29,30,16
Bradshaw's Brae 1,95BB04S1,1399,164,32,132,323,204,146,138,172,199,46,23,23,7
Bradshaw's Brae 2,95BB04S2,1610,276,51,225,462,197,279,127,160,82,25,19,6,2
Carrowdore 1,95BB05S1,1490,146,40,106,316,212,402,132,130,132,20,11,9,0
Carrowdore 2,95BB05S2,1911,180,40,140,419,217,462,141,215,230,44,30,14,3
Central (Ards LGD),95BB06W1,2870,102,28,74,453,362,217,259,644,646,165,114,51,22
Comber East 1,95BB07S1,1601,120,24,96,306,243,160,181,295,220,59,36,23,17
Comber East 2,95BB07S2,1295,109,26,83,268,184,176,153,195,184,23,17,6,3
Comber North 1,95BB08S1,1331,48,7,41,177,155,152,154,213,344,68,43,25,20
Comber North 2,95BB08S2,1294,112,22,90,301,181,158,154,209,161,18,14,4,0
Comber West 1,95BB09S1,1291,170,33,137,323,183,194,102,147,148,21,12,9,3
Comber West 2,95BB09S2,1618,218,53,165,496,299,140,110,155,165,30,9,21,5
Donaghadee North 1,95BB10S1,1663,175,32,143,371,210,172,151,272,232,71,46,25,9
Donaghadee North 2,95BB10S2,1615,299,75,224,474,224,350,45,123,69,27,20,7,4
Donaghadee South 1,95BB11S1,1408,53,10,43,247,178,142,140,264,291,80,42,38,13
Donaghadee South 2,95BB11S2,1495,151,41,110,369,230,197,139,189,176,37,19,18,7
Glen 1,95BB12S1,1440,51,10,41,195,141,78,204,342,305,106,62,44,18
Glen 2,95BB12S2,1336,239,64,175,380,119,167,78,164,138,48,15,33,3
Gregstown 1,95BB13S1,1392,175,44,131,374,170,143,102,229,142,51,25,26,6
Gregstown 2,95BB13S2,1466,74,25,49,271,149,153,142,254,310,94,54,40,19
Gregstown 3,95BB13S3,1580,175,40,135,394,263,211,151,268,95,10,6,4,13
Killinchy 1,95BB14S1,1510,262,46,216,396,134,414,86,82,96,36,30,6,4
Killinchy 2,95BB14S2,1578,336,62,274,479,168,271,80,118,100,18,14,4,8
Kircubbin 1,95BB15S1,2005,186,28,158,386,217,672,131,153,178,79,47,32,3
Kircubbin 2,95BB15S2,1484,58,14,44,226,175,289,116,200,327,85,48,37,8
Lisbane 1,95BB16S1,1533,242,53,189,404,212,365,63,105,122,16,14,2,4
Lisbane 2,95BB16S2,1600,316,49,267,405,181,327,103,111,142,13,11,2,2
Loughries 1,95BB17S1,1793,85,25,60,351,255,254,231,320,233,45,24,21,19
Loughries 2,95BB17S2,1742,130,41,89,383,228,338,131,248,199,73,46,27,12
Millisle 1,95BB18S1,1688,108,19,89,300,207,224,201,303,254,75,45,30,16
Millisle 2,95BB18S2,2524,317,78,239,694,376,532,196,179,179,36,22,14,15
Movilla 1,95BB19S1,1557,101,17,84,300,289,130,219,289,180,41,30,11,8
Movilla 2,95BB19S2,1777,186,47,139,562,285,238,181,161,145,15,4,11,4
Movilla 3,95BB19S3,1391,165,41,124,314,240,135,210,152,158,15,11,4,2
Portaferry 1,95BB20S1,1844,93,9,84,404,163,553,108,187,252,71,39,32,13
Portaferry 2,95BB20S2,1524,91,17,74,250,158,234,114,218,344,89,61,28,26
Portavogie 1,95BB21S1,2379,112,33,79,393,281,533,205,402,339,105,78,27,9
Portavogie 2,95BB21S2,2320,193,18,175,498,216,536,234,296,287,53,32,21,7
Scrabo 1,95BB22S1,1525,133,46,87,209,216,154,171,279,285,73,46,27,5
Scrabo 2,95BB22S2,1468,63,26,37,209,167,119,139,358,276,127,53,74,10
Whitespots 1,95BB23S1,1540,190,43,147,429,255,185,124,210,120,11,6,5,16
Whitespots 2,95BB23S2,1436,145,45,100,405,264,196,143,159,94,30,18,12,0
Abbey Park,95CC01W1,2376,100,32,68,427,244,374,167,370,455,226,138,88,13
Ballymartrim,95CC02W1,2693,196,33,163,461,188,876,150,255,408,143,77,66,16
Callan Bridge,95CC03W1,2791,56,5,51,362,308,261,241,501,639,385,274,111,38
Carrigatuke,95CC04W1,2384,102,18,84,366,168,768,181,200,462,129,76,53,8
Charlemont,95CC05W1,2749,214,64,150,467,240,634,198,326,540,124,75,49,6
Demesne 1,95CC06S1,1458,220,80,140,410,158,221,115,149,141,42,25,17,2
Demesne 2,95CC06S2,1292,99,51,48,312,187,147,94,176,197,73,45,28,7
Derrynoose,95CC07W1,3475,172,35,137,601,280,960,242,364,552,261,185,76,43
Downs,95CC08W1,2511,149,26,123,504,206,318,180,376,464,287,186,101,27
Hamiltonsbawn 1,95CC09S1,1485,171,42,129,263,112,506,140,129,138,20,14,6,6
Hamiltonsbawn 2,95CC09S2,1838,197,59,138,355,220,355,132,235,300,38,28,10,6
Hockley,95CC10W1,2495,304,79,225,571,213,615,183,245,285,64,37,27,15
Keady,95CC11W1,1787,67,20,47,285,131,290,133,224,434,207,148,59,16
Killeen,95CC12W1,2751,169,41,128,443,230,881,242,287,380,109,65,44,10
Killylea,95CC13W1,2474,160,52,108,421,175,764,190,279,384,90,65,25,11
Laurelvale,95CC14W1,3017,219,43,176,656,381,538,302,392,447,67,47,20,15
Loughgall,95CC15W1,2893,241,43,198,547,277,576,295,372,476,96,73,23,13
Markethill,95CC16W1,2801,185,45,140,456,283,553,245,424,481,141,88,53,33
Milford,95CC17W1,2724,221,47,174,535,197,802,203,258,387,112,62,50,9
Observatory,95CC18W1,2309,322,58,264,618,226,292,184,230,308,114,64,50,15
Poyntz Pass,95CC19W1,2720,245,69,176,526,259,765,209,251,327,122,99,23,16
Rich Hill 1,95CC20S1,1308,158,66,92,357,162,161,128,184,130,24,6,18,4
Rich Hill 2,95CC20S2,1658,152,41,111,341,276,178,165,258,242,44,24,20,2
Tandragee,95CC21W1,2925,248,61,187,530,393,380,263,484,480,109,60,49,38
The Mall,95CC22W1,1724,98,30,68,312,225,132,174,328,346,95,56,39,14
Academy,95DD01W1,2031,370,83,287,494,237,250,165,234,210,62,52,10,9
Ahoghill 1,95DD02S1,1453,122,25,97,218,170,121,218,293,260,47,27,20,4
Ahoghill 2,95DD02S2,2419,279,79,200,523,266,322,312,388,265,52,30,22,12
Ardeevin,95DD03W1,3474,551,134,417,960,368,381,333,480,303,68,27,41,30
Ballee,95DD04W1,1926,48,17,31,184,139,98,237,511,493,191,126,65,25
Ballykeel,95DD05W1,1739,68,30,38,171,147,129,173,455,410,177,114,63,9
Ballyloughan,95DD06W1,2427,357,94,263,609,305,279,209,332,280,46,38,8,10
Broughshane 1,95DD07S1,1596,195,60,135,327,162,169,136,288,263,46,25,21,10
Broughshane 2,95DD07S2,1767,227,67,160,434,156,236,153,218,277,49,36,13,17
Castle Demesne,95DD08W1,2083,59,18,41,306,172,147,193,535,486,162,111,51,23
Craigywarren,95DD09W1,2572,287,63,224,486,234,714,228,317,223,74,42,32,9
Cullybackey,95DD10W1,2805,143,41,102,458,239,291,361,610,542,140,80,60,21
Dunclug,95DD11W1,2363,87,23,64,342,182,230,228,557,467,253,162,91,17
Dunminning,95DD12W1,2582,240,41,199,452,193,755,247,315,316,53,33,20,11
Fair Green,95DD13W1,1743,81,18,63,286,139,181,230,375,315,127,80,47,9
Galgorm 1,95DD14S1,1601,152,46,106,361,173,181,194,253,236,50,28,22,1
Galgorm 2,95DD14S2,1667,351,84,267,514,140,268,118,163,86,23,16,7,4
Glenravel,95DD15W1,3451,395,83,312,727,257,851,271,382,426,136,91,45,6
Glenwhirry,95DD16W1,2943,311,46,265,670,224,777,254,282,345,72,57,15,8
Grange,95DD17W1,3461,397,102,295,659,236,1077,304,301,384,96,63,33,7
Harryville,95DD18W1,1813,95,29,66,244,165,187,234,469,324,89,50,39,6
Kells 1,95DD19S1,1855,144,39,105,380,213,256,150,334,318,58,44,14,2
Kells 2,95DD19S2,1460,193,68,125,275,154,294,150,169,184,27,10,17,14
Moat,95DD20W1,1742,38,15,23,146,148,74,183,539,454,148,98,50,12
Park,95DD21W1,2130,150,38,112,400,207,185,198,483,393,95,45,50,19
Portglenone 1,95DD22S1,1537,132,34,98,306,129,401,149,182,181,50,41,9,7
Portglenone 2,95DD22S2,1581,120,27,93,279,133,377,137,254,212,60,47,13,9
Slemish,95DD23W1,2490,236,41,195,483,151,842,212,231,247,80,64,16,8
Summerfield,95DD24W1,2692,292,72,220,658,245,303,261,460,366,93,46,47,14
Ballyhoe and Corkey,95EE01W1,1895,98,25,73,300,133,605,147,216,292,96,53,43,8
Benvardin,95EE02W1,2095,160,34,126,330,175,452,180,333,325,131,80,51,9
Carnany,95EE03W1,1983,108,54,54,374,223,235,162,382,362,117,67,50,20
Clogh Mills,95EE04W1,1990,114,24,90,295,188,443,192,283,367,99,57,42,9
Dervock,95EE05W1,1497,163,33,130,176,133,404,101,200,264,53,26,27,3
Dunloy,95EE06W1,2278,117,36,81,336,152,652,187,298,411,106,50,56,19
Fairhill,95EE07W1,1798,86,17,69,250,198,224,219,358,351,99,50,49,13
Glebe,95EE08W1,1633,178,23,155,367,235,229,83,241,222,76,46,30,2
Killoquin Lower,95EE09W1,1859,128,13,115,256,145,538,190,262,244,82,40,42,14
Killoquin Upper,95EE10W1,1797,105,28,77,241,107,477,159,239,339,126,81,45,4
Knockaholet,95EE11W1,1677,92,12,80,189,122,603,168,187,235,73,42,31,8
Newhill,95EE12W1,2500,141,40,101,397,210,238,187,588,492,223,140,83,24
Route,95EE13W1,1529,126,37,89,275,160,215,117,249,255,115,84,31,17
Seacon,95EE14W1,2684,219,61,158,536,256,469,250,404,449,94,66,28,7
Stranocum,95EE15W1,1728,88,42,46,238,130,583,120,189,285,81,62,19,14
The Vow,95EE16W1,2111,181,37,144,339,197,578,193,232,312,74,45,29,5
Ballydown 1,95FF01S1,2098,222,67,155,594,307,249,177,294,218,26,20,6,11
Ballydown 2,95FF01S2,2655,517,87,430,739,365,348,156,276,183,52,26,26,19
Ballyward,95FF02W1,2817,184,41,143,459,226,1093,157,208,336,135,82,53,19
Banbridge West,95FF03W1,3006,179,33,146,590,427,342,324,509,500,123,59,64,12
Bannside,95FF04W1,2629,285,65,220,466,207,862,179,244,287,91,52,39,8
Dromore North,95FF05W1,2563,302,84,218,557,299,302,218,335,424,116,73,43,10
Dromore South 1,95FF06S1,1974,241,45,196,427,313,239,141,278,270,56,43,13,9
Dromore South 2,95FF06S2,2080,309,106,203,601,230,309,216,201,177,32,12,20,5
Edenderry,95FF07W1,2763,150,49,101,430,331,281,247,557,545,190,99,91,32
Fort,95FF08W1,2328,238,39,199,467,326,300,232,322,338,86,45,41,19
Gilford,95FF09W1,2521,191,53,138,420,206,420,298,399,453,102,71,31,32
Gransha,95FF10W1,3473,381,99,282,799,361,914,234,315,367,93,56,37,9
Katesbridge,95FF11W1,2582,216,20,196,395,215,829,222,207,403,89,57,32,6
Lawrencetown,95FF12W1,2721,286,100,186,574,242,544,259,336,355,113,79,34,12
Loughbrickland,95FF13W1,2708,319,78,241,520,251,677,168,259,401,88,68,20,25
Quilly,95FF14W1,2413,390,110,280,597,163,635,196,146,234,40,25,15,12
Rathfriland,95FF15W1,2680,162,44,118,453,218,423,213,444,562,174,141,33,31
Seapatrick,95FF16W1,2317,348,46,302,559,317,277,193,242,304,66,48,18,11
The Cut,95FF17W1,1717,74,26,48,322,193,153,163,316,365,120,75,45,11
Andersonstown 1,95GG01S1,1765,107,20,87,357,260,253,149,249,269,114,103,11,7
Andersonstown 2,95GG01S2,1464,58,20,38,265,215,139,144,212,297,127,92,35,7
Andersonstown 3,95GG01S3,1616,82,18,64,318,191,164,121,285,307,144,110,34,4
Ardoyne 1,95GG02S1,1745,56,13,43,167,149,67,102,392,400,384,306,78,28
Ardoyne 2,95GG02S2,2018,28,8,20,156,241,79,174,446,463,403,310,93,28
Ardoyne 3,95GG02S3,2224,29,12,17,147,212,60,143,483,554,554,481,73,42
Ballyhackamore 1,95GG03S1,1952,419,70,349,673,264,150,99,175,111,50,33,17,11
Ballyhackamore 2,95GG03S2,1833,426,58,368,570,263,170,114,139,98,37,23,14,16
Ballyhackamore 3,95GG03S3,2072,336,67,269,586,273,178,134,272,212,54,35,19,27
Ballymacarrett 1,95GG04S1,1708,129,18,111,182,184,60,104,352,386,282,223,59,29
Ballymacarrett 2,95GG04S2,1564,29,0,29,150,176,63,145,386,385,224,179,45,6
Ballymacarrett 3,95GG04S3,1636,58,9,49,171,201,40,151,372,440,193,134,59,10
Ballynafeigh 1,95GG05S1,1777,346,26,320,523,233,70,116,259,141,79,56,23,10
Ballynafeigh 2,95GG05S2,2009,335,27,308,585,289,111,119,260,191,61,49,12,58
Ballynafeigh 3,95GG05S3,2106,307,31,276,386,284,97,203,323,256,193,129,64,57
Ballysillan 1,95GG06S1,1866,57,11,46,232,217,99,192,377,450,231,149,82,11
Ballysillan 2,95GG06S2,1779,57,21,36,258,206,98,236,369,437,106,78,28,12
Ballysillan 3,95GG06S3,1922,189,34,155,344,276,174,194,341,324,69,47,22,11
Beechmount 1,95GG07S1,1844,70,17,53,433,285,85,114,363,290,182,149,33,22
Beechmount 2,95GG07S2,1922,64,21,43,211,293,84,114,386,384,346,297,49,40
Beechmount 3,95GG07S3,1701,57,11,46,175,243,91,129,354,443,184,137,47,25
Bellevue 1,95GG08S1,1394,214,29,185,342,195,156,93,158,169,51,33,18,16
Bellevue 2,95GG08S2,1730,80,21,59,230,219,135,142,366,373,163,118,45,22
Bellevue 3,95GG08S3,1786,176,22,154,408,180,132,161,375,239,99,63,36,16
Belmont 1,95GG09S1,2089,602,99,503,651,264,224,87,121,103,27,24,3,10
Belmont 2,95GG09S2,1856,252,56,196,538,289,102,169,253,218,30,15,15,5
Belmont 3,95GG09S3,2110,179,41,138,401,242,108,176,484,353,155,100,55,12
Blackstaff 1,95GG10S1,1826,79,12,67,260,234,59,161,361,463,147,84,63,62
Blackstaff 2,95GG10S2,2171,113,29,84,321,237,62,214,477,447,186,136,50,114
Bloomfield 1 (Belfast LGD),95GG11S1,1895,119,7,112,340,216,88,194,412,367,146,91,55,13
Bloomfield 2 (Belfast LGD),95GG11S2,1636,333,42,291,489,191,160,93,161,153,33,21,12,23
Bloomfield 3 (Belfast LGD),95GG11S3,1858,144,12,132,396,230,74,211,336,337,110,73,37,20
Botanic 1,95GG12S1,1488,248,15,233,155,120,56,79,118,45,43,19,24,624
Botanic 2,95GG12S2,1958,166,6,160,188,149,37,99,165,89,41,33,8,1024
Botanic 3,95GG12S3,1477,216,4,212,168,94,32,99,113,85,52,42,10,618
Botanic 4,95GG12S4,1626,124,8,116,237,180,63,77,178,66,57,19,38,644
Botanic 5,95GG12S5,2177,161,37,124,329,268,62,180,389,316,313,261,52,159
Castleview 1,95GG13S1,1329,71,22,49,203,185,52,116,289,262,134,83,51,17
Castleview 2,95GG13S2,1731,391,82,309,509,200,200,91,137,147,54,44,10,2
Castleview 3,95GG13S3,1637,202,27,175,283,205,141,155,293,275,76,50,26,7
Cavehill 1,95GG14S1,1617,299,62,237,527,235,126,147,139,106,22,16,6,16
Cavehill 2,95GG14S2,1597,467,31,436,498,152,200,53,114,62,44,30,14,7
Cavehill 3,95GG14S3,1606,288,50,238,498,196,135,131,164,149,30,18,12,15
Cherryvalley 1,95GG15S1,1805,577,120,457,682,202,166,56,66,21,23,15,8,12
Cherryvalley 2,95GG15S2,2004,428,70,358,673,319,198,92,157,88,36,15,21,13
Cherryvalley 3,95GG15S3,1881,244,30,214,467,275,135,155,294,227,56,37,19,28
Chichester Park 1,95GG16S1,1960,134,18,116,382,273,109,159,384,325,166,116,50,28
Chichester Park 2,95GG16S2,1920,294,46,248,496,277,184,119,226,163,138,106,32,23
Chichester Park 3,95GG16S3,1486,175,43,132,419,191,93,95,181,251,61,44,17,20
Cliftonville 1,95GG17S1,2031,127,19,108,321,244,195,149,390,258,321,231,90,26
Cliftonville 2,95GG17S2,1595,120,40,80,386,228,181,131,199,259,85,61,24,6
Cliftonville 3,95GG17S3,1704,87,8,79,190,182,120,153,358,357,210,140,70,47
Clonard 1,95GG18S1,2553,79,14,65,263,347,73,170,548,598,426,373,53,49
Clonard 2,95GG18S2,2422,107,4,103,300,327,82,169,471,571,366,297,69,29
Crumlin 1 (Belfast LGD),95GG19S1,1961,19,7,12,108,158,78,166,406,702,312,238,74,12
Crumlin 2 (Belfast LGD),95GG19S2,2563,54,17,37,229,218,85,206,648,668,424,332,92,31
Duncairn 1,95GG20S1,2698,235,27,208,374,275,122,186,512,629,288,198,90,77
Duncairn 2,95GG20S2,2094,104,14,90,242,201,143,189,450,502,235,177,58,28
Falls 1,95GG21S1,1482,28,3,25,105,111,49,88,338,393,338,283,55,32
Falls 2,95GG21S2,1699,18,5,13,165,179,31,105,254,440,462,407,55,45
Falls 3,95GG21S3,1898,103,4,99,276,206,78,140,304,461,301,233,68,29
Falls Park 1,95GG22S1,1687,113,25,88,399,258,152,123,265,248,104,86,18,25
Falls Park 2,95GG22S2,1894,91,35,56,424,297,148,150,297,358,113,94,19,16
Falls Park 3,95GG22S3,1709,111,15,96,315,240,142,126,304,341,116,92,24,14
Finaghy 1,95GG23S1,1418,313,46,267,359,191,115,88,189,143,14,7,7,6
Finaghy 2,95GG23S2,1496,353,85,268,510,161,135,79,131,91,27,14,13,9
Finaghy 3,95GG23S3,1585,294,32,262,465,213,161,109,175,133,33,16,17,2
Fortwilliam 1,95GG24S1,1286,208,38,170,322,197,120,58,198,134,38,29,9,11
Fortwilliam 2,95GG24S2,1540,85,19,66,282,194,100,162,334,296,73,47,26,14
Fortwilliam 3,95GG24S3,1538,346,64,282,425,157,154,90,170,134,57,47,10,5
Glen Road 1,95GG25S1,2112,121,16,105,404,316,139,182,393,347,182,141,41,28
Glen Road 2,95GG25S2,1839,106,17,89,326,281,176,167,310,330,138,95,43,5
Glen Road 3,95GG25S3,1576,61,20,41,267,239,126,130,298,289,140,107,33,26
Glencairn 1,95GG26S1,1948,43,13,30,202,195,107,198,449,476,254,213,41,24
Glencairn 2,95GG26S2,1727,48,11,37,222,222,89,181,386,401,163,116,47,15
Glencolin 1,95GG27S1,1500,141,32,109,320,201,182,140,221,182,100,70,30,13
Glencolin 2,95GG27S2,1614,74,6,68,258,237,95,102,298,335,192,162,30,23
Glencolin 3,95GG27S3,1705,78,10,68,288,232,124,133,346,316,170,109,61,18
Glencolin 4,95GG27S4,1587,48,6,42,218,211,98,108,367,305,217,172,45,15
Highfield 1,95GG28S1,2149,145,27,118,416,315,192,262,365,345,100,72,28,9
Highfield 2,95GG28S2,1717,65,14,51,281,238,138,177,342,346,97,55,42,33
Highfield 3,95GG28S3,1769,35,14,21,178,177,47,196,437,460,211,139,72,28
Island 1,95GG29S1,2257,247,33,214,316,196,91,188,440,507,236,170,66,36
Island 2,95GG29S2,2747,263,48,215,529,398,150,254,525,453,153,109,44,22
Knock 1,95GG30S1,1604,171,36,135,303,193,167,126,258,298,71,37,34,17
Knock 2,95GG30S2,1685,393,87,306,554,184,158,122,99,130,37,20,17,8
Knock 3,95GG30S3,1538,128,28,100,404,260,100,187,240,190,13,13,0,16
Ladybrook 1,95GG31S1,2227,207,29,178,620,370,237,164,289,253,68,32,36,19
Ladybrook 2,95GG31S2,2032,108,28,80,416,238,196,222,340,385,120,78,42,7
Ladybrook 3,95GG31S3,2260,80,14,66,299,297,132,176,476,399,367,271,96,34
Legoniel 1,95GG32S1,3232,195,27,168,516,433,202,217,685,573,381,278,103,30
Legoniel 2,95GG32S2,1553,78,15,63,202,195,84,206,292,379,107,82,25,10
Legoniel 3,95GG32S3,1606,122,30,92,336,203,142,139,261,295,91,65,26,17
Malone 1,95GG33S1,1945,900,89,811,549,113,224,21,61,38,21,13,8,18
Malone 2,95GG33S2,1595,678,70,608,464,103,180,36,64,24,25,14,11,21
Malone 3,95GG33S3,1912,694,47,647,611,193,130,68,86,59,36,25,11,35
Musgrave 1,95GG34S1,1441,151,25,126,298,218,82,130,244,231,78,49,29,9
Musgrave 2,95GG34S2,1590,213,49,164,539,251,129,104,146,155,43,27,16,10
Musgrave 3,95GG34S3,1835,394,41,353,596,268,158,134,156,78,42,32,10,9
New Lodge 1,95GG35S1,1889,72,16,56,174,182,60,130,371,487,394,324,70,19
New Lodge 2,95GG35S2,1478,45,16,29,139,146,48,90,280,363,351,309,42,16
New Lodge 3,95GG35S3,1502,49,19,30,150,136,53,135,331,310,326,281,45,12
Orangefield 1,95GG36S1,1794,237,49,188,399,234,198,170,244,243,56,42,14,13
Orangefield 2,95GG36S2,1926,274,30,244,517,290,197,217,201,197,29,21,8,4
Orangefield 3,95GG36S3,1899,221,44,177,483,270,159,185,272,254,47,33,14,8
Ravenhill 1,95GG37S1,1972,700,83,617,616,153,149,92,133,82,21,1,20,26
Ravenhill 2,95GG37S2,1786,338,50,288,480,234,103,150,225,168,75,34,41,13
Ravenhill 3,95GG37S3,2133,457,36,421,571,315,124,143,229,224,57,39,18,13
Rosetta 1,95GG38S1,3044,998,95,903,929,272,255,122,182,146,86,54,32,54
Rosetta 2,95GG38S2,1752,493,45,448,487,203,100,56,160,162,62,32,30,29
Rosetta 3,95GG38S3,1583,445,51,394,533,153,140,73,124,83,30,23,7,2
Shaftesbury 1,95GG39S1,2401,467,40,427,355,226,116,147,349,379,318,264,54,44
Shaftesbury 2,95GG39S2,2709,235,13,222,463,224,123,290,404,504,323,268,55,143
Shaftesbury 3,95GG39S3,2062,130,5,125,284,207,56,172,349,416,236,200,36,212
Shankill 1,95GG40S1,1697,41,6,35,166,98,103,129,364,519,263,221,42,14
Shankill 2,95GG40S2,2008,73,8,65,151,140,61,163,415,576,415,322,93,14
Stormont 1,95GG41S1,1891,595,128,467,722,208,180,43,55,74,14,12,2,0
Stormont 2,95GG41S2,1524,563,85,478,452,159,154,59,43,72,15,13,2,7
Stormont 3,95GG41S3,1857,513,66,447,602,224,212,67,97,101,33,25,8,8
Stranmillis 1,95GG42S1,1826,762,70,692,525,145,197,63,57,32,24,15,9,21
Stranmillis 2,95GG42S2,516,194,37,157,124,38,39,14,26,8,7,4,3,66
Stranmillis 3,95GG42S3,2003,487,50,437,393,183,63,46,89,32,24,5,19,686
Stranmillis 4,95GG42S4,2247,815,66,749,681,246,152,91,104,72,32,20,12,54
Sydenham 1,95GG43S1,1424,105,8,97,286,190,81,110,303,269,72,39,33,8
Sydenham 2,95GG43S2,1635,150,37,113,274,250,119,184,316,260,50,40,10,32
Sydenham 3,95GG43S3,1724,159,36,123,357,228,101,153,355,281,77,34,43,13
The Mount 1,95GG44S1,2864,151,25,126,385,297,105,261,660,630,340,270,70,35
The Mount 2,95GG44S2,2727,165,21,144,375,247,109,252,625,634,262,202,60,58
Upper Malone 1,95GG45S1,1646,639,90,549,470,134,230,31,72,38,23,14,9,9
Upper Malone 2,95GG45S2,1554,93,26,67,220,189,40,128,331,362,159,114,45,32
Upper Malone 3,95GG45S3,1617,313,41,272,418,215,93,85,201,209,59,38,21,24
Upper Springfield 1,95GG46S1,1712,43,9,34,189,196,97,108,312,427,323,276,47,17
Upper Springfield 2,95GG46S2,1828,29,6,23,199,171,101,130,322,467,371,300,71,38
Upper Springfield 3,95GG46S3,1664,48,17,31,129,172,77,94,345,406,378,325,53,15
Water Works 1,95GG47S1,2270,84,17,67,290,226,120,127,497,469,398,280,118,59
Water Works 2,95GG47S2,1696,49,6,43,179,191,131,129,380,293,312,271,41,32
Water Works 3,95GG47S3,1798,107,12,95,264,215,113,172,308,335,265,179,86,19
Whiterock 1,95GG48S1,1612,42,4,38,152,230,71,114,318,416,250,186,64,19
Whiterock 2,95GG48S2,2321,36,9,27,177,252,35,141,558,452,616,548,68,54
Whiterock 3,95GG48S3,1668,36,4,32,146,217,57,88,363,355,396,359,37,10
Windsor 1,95GG49S1,1617,449,18,431,422,173,119,66,192,64,38,21,17,94
Windsor 2,95GG49S2,2214,403,17,386,366,246,66,130,205,103,54,38,16,641
Windsor 3,95GG49S3,2139,211,2,209,342,159,44,132,264,150,61,45,16,776
Windsor 4,95GG49S4,2066,174,2,172,351,224,61,135,218,121,57,36,21,725
Woodstock 1,95GG50S1,1499,119,14,105,263,189,64,153,316,277,102,53,49,16
Woodstock 2,95GG50S2,2061,118,11,107,280,212,114,211,436,430,220,150,70,40
Woodstock 3,95GG50S3,1885,123,15,108,296,255,94,175,348,395,165,99,66,34
Woodvale 1,95GG51S1,1353,38,6,32,140,194,56,144,301,291,181,127,54,8
Woodvale 2,95GG51S2,1399,44,12,32,130,117,68,150,320,394,162,111,51,14
Woodvale 3,95GG51S3,1321,27,3,24,104,131,43,95,318,406,188,155,33,9
Blackhead,95HH01W1,1981,244,50,194,532,259,171,198,277,209,87,49,38,4
Bluefield 1,95HH02S1,1358,160,34,126,370,232,97,136,185,123,52,25,27,3
Bluefield 2,95HH02S2,1604,238,72,166,452,271,188,161,163,107,15,5,10,9
Boneybefore,95HH03W1,1663,226,25,201,450,240,163,163,200,175,32,18,14,14
Burleigh Hill 1,95HH04S1,1709,206,60,146,386,275,112,213,257,226,28,15,13,6
Burleigh Hill 2,95HH04S2,1358,228,70,158,301,216,129,158,145,163,14,5,9,4
Clipperstown,95HH05W1,2171,92,31,61,277,295,117,273,508,439,154,66,88,16
Eden 1,95HH06S1,2231,351,100,251,575,327,291,281,207,150,43,22,21,6
Eden 2,95HH06S2,2557,264,65,199,661,404,257,276,339,281,69,45,24,6
Gortalee,95HH07W1,1493,82,29,53,239,185,101,157,262,329,121,54,67,17
Greenisland,95HH08W1,2553,433,62,371,647,353,301,190,242,308,45,14,31,34
Killycrot,95HH09W1,2543,206,51,155,491,374,183,228,458,422,155,94,61,26
Knockagh,95HH10W1,2488,537,107,430,833,333,244,140,201,141,47,12,35,12
Love Lane,95HH11W1,1366,65,16,49,173,158,87,155,300,287,129,62,67,12
Milebush,95HH12W1,1552,110,22,88,320,278,131,161,238,261,50,26,24,3
Northland,95HH13W1,1407,31,12,19,158,172,97,167,306,360,102,61,41,14
Sunnylands,95HH14W1,1530,42,10,32,200,157,94,201,347,360,106,71,35,23
Victoria (Carrickfergus LGD),95HH15W1,2585,254,79,175,615,373,201,265,409,354,96,51,45,18
Whitehead,95HH16W1,2159,328,67,261,648,285,234,162,232,201,57,32,25,12
Woodburn,95HH17W1,2477,253,53,200,503,391,423,271,305,255,53,37,16,23
Ballyhanwood 1,95II01S1,1532,220,62,158,424,255,190,110,168,141,22,17,5,2
Ballyhanwood 2,95II01S2,1534,278,60,218,481,225,240,67,119,106,8,4,4,10
Beechill 1,95II02S1,1485,466,42,424,522,170,133,57,83,30,13,9,4,11
Beechill 2,95II02S2,1700,386,76,310,487,215,135,90,212,131,39,23,16,5
Beechill 3,95II02S3,1415,231,27,204,336,186,94,100,227,160,77,52,25,4
Cairnshill 1,95II03S1,1739,562,142,420,482,225,149,139,94,56,20,14,6,12
Cairnshill 2,95II03S2,1784,385,36,349,572,269,157,147,121,107,16,12,4,10
Carrowreagh 1,95II04S1,2293,342,72,270,649,390,243,181,252,185,36,20,16,15
Carrowreagh 2,95II04S2,1952,134,29,105,325,264,117,225,382,383,98,56,42,24
Carryduff East 1,95II05S1,1586,413,80,333,554,185,237,61,63,60,13,2,11,0
Carryduff East 2,95II05S2,1826,257,35,222,522,259,144,126,216,226,49,30,19,27
Carryduff West 1,95II06S1,1519,402,64,338,505,181,175,99,68,82,7,4,3,0
Carryduff West 2,95II06S2,1879,318,51,267,590,294,148,163,168,142,49,23,26,7
Cregagh,95II07W1,2077,125,21,104,269,251,168,212,443,479,120,71,49,10
Downshire,95II08W1,2417,192,35,157,534,422,201,300,406,286,55,33,22,21
Dundonald 1,95II09S1,1934,268,61,207,555,308,154,166,246,195,32,25,7,10
Dundonald 2,95II09S2,1413,163,30,133,392,236,122,175,162,130,24,12,12,9
Enler,95II10W1,2592,158,28,130,354,375,207,272,535,539,132,80,52,20
Galwally,95II11W1,2555,615,75,540,830,413,164,177,193,108,39,35,4,16
Gilnahirk,95II12W1,2481,480,86,394,941,334,240,168,166,98,49,31,18,5
Graham's Bridge,95II13W1,2701,162,29,133,552,388,268,261,553,382,116,67,49,19
Hillfoot,95II14W1,2521,554,71,483,866,391,235,135,202,107,26,20,6,5
Knockbracken 1,95II15S1,1793,467,53,414,616,176,215,114,100,75,21,10,11,9
Knockbracken 2,95II15S2,1564,374,74,300,548,254,110,81,118,54,25,21,4,0
Lisnasharragh,95II16W1,2126,168,29,139,382,338,125,256,424,344,80,53,27,9
Lower Braniel,95II17W1,2493,335,62,273,509,381,222,218,439,289,97,55,42,3
Minnowburn,95II18W1,2226,183,33,150,413,333,123,226,423,417,85,53,32,23
Moneyreagh 1,95II19S1,1826,436,84,352,509,182,372,103,115,91,13,13,0,5
Moneyreagh 2,95II19S2,1939,275,65,210,435,327,267,173,205,203,44,32,12,10
Newtownbreda,95II20W1,2743,556,78,478,814,366,185,222,340,179,55,30,25,26
Tullycarnet,95II21W1,2419,106,30,76,327,309,169,204,546,537,192,120,72,29
Upper Braniel,95II22W1,2248,245,74,171,449,383,256,225,312,301,68,33,35,9
Wynchurch,95II23W1,2190,424,69,355,630,254,165,189,267,190,52,29,23,19
Agivey,95JJ01W1,2495,262,64,198,418,238,701,179,302,306,82,59,23,7
Atlantic,95JJ02W1,2367,296,42,254,616,244,256,175,290,270,165,90,75,55
Ballysally 1,95JJ03S1,1406,20,4,16,131,147,91,132,348,320,193,139,54,24
Ballysally 2,95JJ03S2,1064,24,3,21,158,104,116,86,246,228,83,43,40,19
Castlerock 1,95JJ04S1,1546,151,28,123,270,193,258,139,181,248,96,46,50,10
Castlerock 2,95JJ04S2,1565,202,51,151,373,183,217,128,206,160,87,53,34,9
Central (Coleraine LGD),95JJ05W1,1775,79,14,65,178,155,142,182,429,424,159,106,53,27
Churchland,95JJ06W1,2432,43,8,35,330,274,185,262,524,567,226,156,70,21
Cross Glebe,95JJ07W1,2596,97,13,84,288,258,161,279,656,607,229,141,88,21
Dundooan 1,95JJ08S1,1377,109,6,103,214,146,359,119,179,180,69,47,22,2
Dundooan 2,95JJ08S2,1720,266,39,227,449,169,222,91,150,103,56,31,25,214
Dunluce,95JJ09W1,1986,236,28,208,422,156,534,134,192,249,60,49,11,3
Garvagh,95JJ10W1,2795,209,46,163,390,159,703,220,391,516,188,130,58,19
Hopefield 1,95JJ11S1,1821,211,27,184,455,254,249,139,226,194,86,54,32,7
Hopefield 2,95JJ11S2,1943,265,37,228,522,255,286,158,198,143,75,47,28,41
Kilrea,95JJ12W1,2709,209,61,148,403,226,694,234,330,437,167,122,45,9
Knocklynn 1,95JJ13S1,2144,288,44,244,492,283,260,174,318,247,62,36,26,20
Knocklynn 2,95JJ13S2,1751,265,48,217,442,330,179,101,221,178,27,17,10,8
Macosquin,95JJ14W1,2325,220,26,194,390,249,599,185,251,314,99,71,28,18
Mount Sandel,95JJ15W1,1762,272,32,240,473,228,192,116,221,187,67,45,22,6
Portstewart,95JJ16W1,1755,168,29,139,324,181,209,191,274,221,118,90,28,69
Ringsend,95JJ17W1,2443,233,53,180,380,199,815,158,200,325,124,101,23,9
Royal Portrush,95JJ18W1,1937,197,27,170,386,172,313,201,265,258,124,82,42,21
Strand 1 (Coleraine LGD),95JJ19S1,1645,308,29,279,476,148,171,77,125,72,25,12,13,243
Strand 2 (Coleraine LGD),95JJ19S2,1251,162,18,144,261,105,105,61,90,38,21,15,6,408
The Cuts 1,95JJ20S1,2173,242,53,189,603,390,230,170,245,225,58,43,15,10
The Cuts 2,95JJ20S2,1919,114,32,82,384,271,190,203,381,268,82,50,32,26
University,95JJ21W1,2292,166,15,151,366,231,224,168,414,387,220,155,65,116
Waterside,95JJ22W1,2767,437,94,343,844,439,298,184,271,219,45,30,15,30
Ardboe,95KK01W1,2578,107,30,77,381,156,699,187,309,464,263,201,62,12
Coagh,95KK02W1,2000,153,37,116,311,120,512,207,191,418,78,54,24,10
Dunnamore,95KK03W1,2344,110,35,75,247,166,786,198,213,462,157,124,33,5
Gortalowry,95KK04W1,2787,190,58,132,424,222,359,285,521,600,179,122,57,7
Killycolpy,95KK05W1,2587,137,32,105,369,179,789,210,271,400,213,169,44,19
Killymoon,95KK06W1,1885,93,35,58,256,163,267,187,353,426,122,88,34,18
Lissan,95KK07W1,2045,152,40,112,289,153,544,237,241,340,89,75,14,0
Moneymore,95KK08W1,2612,175,47,128,457,188,563,209,395,477,132,89,43,16
Newbuildings,95KK09W1,2154,139,36,103,315,187,279,230,356,489,144,100,44,15
Oaklands,95KK10W1,2181,151,21,130,303,142,693,209,223,369,75,55,20,16
Oldtown,95KK11W1,2373,113,41,72,380,223,273,195,519,494,151,86,65,25
Pomeroy,95KK12W1,2309,96,15,81,311,163,657,171,285,412,212,152,60,2
Sandholes,95KK13W1,1769,111,37,74,325,75,554,164,161,270,95,62,33,14
Stewartstown,95KK14W1,2041,115,50,65,290,193,533,125,223,419,124,86,38,19
The Loop,95KK15W1,2918,262,114,148,507,203,779,202,294,518,149,111,38,4
Tullagh,95KK16W1,2128,158,65,93,380,172,353,218,287,387,138,94,44,35
Aghagallon 1,95LL01S1,2488,307,64,243,548,198,510,173,263,393,87,54,33,9
Aghagallon 2,95LL01S2,2443,293,79,214,528,253,463,250,246,332,61,34,27,17
Annagh 1,95LL02S1,1612,180,50,130,336,216,230,150,245,225,26,17,9,4
Annagh 2,95LL02S2,1411,61,20,41,174,90,81,181,395,310,101,78,23,18
Ballybay,95LL03W1,2436,104,49,55,315,230,211,302,516,587,151,86,65,20
Ballyoran,95LL04W1,2938,174,50,124,461,273,337,262,547,646,204,119,85,34
Bleary 1,95LL05S1,2345,410,92,318,678,218,395,190,235,173,31,17,14,15
Bleary 2,95LL05S2,1736,163,38,125,334,185,333,186,211,206,78,56,22,40
Brownstown 1,95LL06S1,1654,91,23,68,295,202,228,166,288,302,74,38,36,8
Brownstown 2,95LL06S2,1674,100,30,70,260,212,136,207,334,333,81,46,35,11
Church,95LL07W1,2131,58,18,40,157,215,111,283,532,591,163,102,61,21
Corcrain 1,95LL08S1,1649,47,21,26,152,164,134,144,412,392,197,137,60,7
Corcrain 2,95LL08S2,1651,32,12,20,212,123,93,132,426,441,180,110,70,12
Court 1,95LL09S1,1448,26,11,15,122,154,65,169,362,383,159,99,60,8
Court 2,95LL09S2,1565,60,26,34,206,148,151,146,345,345,154,118,36,10
Derrytrasna 1,95LL10S1,3074,303,76,227,684,348,459,273,442,471,67,43,24,27
Derrytrasna 2,95LL10S2,2401,227,87,140,577,229,497,164,336,270,93,50,43,8
Donaghcloney 1,95LL11S1,1538,181,29,152,320,207,267,137,142,237,38,29,9,9
Donaghcloney 2,95LL11S2,2428,309,88,221,663,254,428,185,212,301,47,18,29,29
Drumgask 1,95LL12S1,2929,108,34,74,372,285,263,281,719,590,280,176,104,31
Drumgask 2,95LL12S2,1283,21,12,9,71,111,73,92,319,319,253,173,80,24
Drumgor 1,95LL13S1,1401,89,20,69,242,138,118,148,359,224,75,54,21,8
Drumgor 2,95LL13S2,1344,49,5,44,171,122,90,132,298,344,122,82,40,16
Drumnamoe 1,95LL14S1,1270,24,7,17,103,73,82,112,309,384,169,129,40,14
Drumnamoe 2,95LL14S2,1381,100,35,65,190,149,171,165,257,269,76,41,35,4
Edenderry 1,95LL15S1,1446,201,45,156,268,171,163,131,192,221,88,65,23,11
Edenderry 2,95LL15S2,1540,134,30,104,314,241,120,175,285,214,44,32,12,13
Kernan 1,95LL16S1,2789,489,118,371,770,362,342,212,296,268,44,32,12,6
Kernan 2,95LL16S2,3256,318,76,242,728,342,290,399,537,524,90,48,42,28
Killycomain,95LL17W1,2529,251,44,207,539,289,228,267,433,384,121,63,58,17
Knocknashane 1,95LL18S1,1954,244,65,179,464,264,223,206,253,252,42,27,15,6
Knocknashane 2,95LL18S2,1377,154,45,109,352,217,110,152,202,153,27,21,6,10
Magheralin 1,95LL19S1,2283,316,106,210,599,304,294,229,248,236,52,23,29,5
Magheralin 2,95LL19S2,2865,456,102,354,716,252,501,225,327,303,77,36,41,8
Mourneview,95LL20W1,2401,80,35,45,320,206,214,317,514,581,135,84,51,34
Parklake,95LL21W1,3983,264,47,217,746,412,385,421,758,732,238,127,111,27
Taghnevan,95LL22W1,3728,212,46,166,582,424,343,394,755,717,259,134,125,42
Tavanagh,95LL23W1,2157,60,16,44,250,217,109,268,556,564,125,74,51,8
The Birches 1,95LL24S1,2027,181,52,129,455,190,516,180,152,301,48,31,17,4
The Birches 2,95LL24S2,1716,129,23,106,298,166,383,138,236,270,96,52,44,0
Waringstown 1,95LL25S1,2583,309,50,259,680,289,403,258,287,275,74,58,16,8
Waringstown 2,95LL25S2,1953,285,91,194,514,366,235,183,187,152,27,13,14,4
Woodville 1,95LL26S1,1517,50,9,41,155,151,87,141,368,389,154,88,66,22
Woodville 2,95LL26S2,2179,327,87,240,491,239,300,179,316,240,53,30,23,34
Altnagelvin 1,95MM01S1,1427,73,13,60,136,139,117,134,256,351,210,147,63,11
Altnagelvin 2,95MM01S2,1734,223,51,172,544,189,166,105,243,177,77,26,51,10
Altnagelvin 3,95MM01S3,1614,140,28,112,369,233,160,150,213,250,88,47,41,11
Ballynashallog 1,95MM02S1,1507,254,44,210,414,109,215,101,155,178,75,50,25,6
Ballynashallog 2,95MM02S2,1685,372,92,280,604,144,255,73,119,71,29,23,6,18
Banagher,95MM03W1,3508,252,64,188,585,263,977,203,351,543,309,184,125,25
Beechwood,95MM04W1,2151,69,10,59,366,191,147,209,382,483,274,168,106,30
Brandywell,95MM05W1,2473,69,30,39,247,216,191,149,507,518,529,371,158,47
Carn Hill 1,95MM06S1,1376,70,18,52,205,129,143,143,230,296,146,89,57,14
Carn Hill 2,95MM06S2,1176,37,6,31,175,92,106,89,252,248,161,118,43,16
Caw,95MM07W1,2578,202,38,164,447,306,202,234,470,442,255,186,69,20
Clondermot 1,95MM08S1,1291,39,2,37,205,117,112,89,272,271,177,130,47,9
Clondermot 2,95MM08S2,1651,174,38,136,435,243,205,174,170,195,49,41,8,6
Claudy 1,95MM09S1,1588,144,24,120,288,172,324,140,161,227,124,83,41,8
Claudy 2,95MM09S2,1974,141,30,111,324,162,548,210,207,246,130,74,56,6
Creggan Central 1,95MM10S1,1456,21,0,21,142,121,38,83,308,359,347,248,99,37
Creggan Central 2,95MM10S2,1294,37,10,27,184,108,134,91,272,232,218,141,77,18
Creggan South,95MM11W1,2277,39,6,33,185,156,146,170,493,542,513,350,163,33
Crevagh 1,95MM12S1,2022,206,50,156,364,175,281,124,348,320,167,114,53,37
Crevagh 2,95MM12S2,1298,34,15,19,130,129,54,97,288,236,307,243,64,23
Crevagh 3,95MM12S3,2538,110,38,72,514,204,295,218,487,349,315,211,104,46
Culmore 1,95MM13S1,1205,171,30,141,336,176,139,103,133,112,31,25,6,4
Culmore 2,95MM13S2,1236,21,8,13,117,131,65,67,262,301,257,181,76,15
Culmore 3,95MM13S3,1569,53,19,34,199,113,157,154,276,335,247,180,67,35
Culmore 4,95MM13S4,2553,173,58,115,572,239,254,206,400,427,251,184,67,31
Culmore 5,95MM13S5,2309,406,100,306,794,174,340,139,193,180,79,47,32,4
Ebrington 1,95MM14S1,768,118,26,92,173,73,60,56,125,113,43,25,18,7
Ebrington 2,95MM14S2,1676,61,8,53,259,176,91,150,311,355,238,147,91,35
Eglinton 1,95MM15S1,1681,187,58,129,414,198,263,109,194,217,93,76,17,6
Eglinton 2,95MM15S2,2648,376,97,279,668,391,349,211,281,245,108,74,34,19
Enagh 1 (Derry LGD),95MM16S1,2407,162,19,143,432,228,211,235,431,457,230,170,60,21
Enagh 2 (Derry LGD),95MM16S2,3271,614,121,493,871,379,484,211,350,210,111,51,60,41
Foyle Springs 1,95MM17S1,1962,193,56,137,569,280,267,166,212,194,61,23,38,20
Foyle Springs 2,95MM17S2,1787,145,29,116,398,204,194,168,202,280,172,132,40,24
Holly Mount 1,95MM18S1,2241,154,46,108,373,196,448,155,271,475,142,99,43,27
Holly Mount 2,95MM18S2,2875,368,81,287,739,316,371,220,387,313,127,82,45,34
Kilfennan 1,95MM19S1,1558,130,38,92,409,200,153,175,234,182,63,28,35,12
Kilfennan 2,95MM19S2,1486,115,23,92,352,215,126,176,213,201,72,45,27,16
Lisnagelvin 1,95MM20S1,1606,97,25,72,309,237,122,196,243,299,94,51,43,9
Lisnagelvin 2,95MM20S2,1752,95,34,61,364,242,127,193,326,283,101,53,48,21
New Buildings 1,95MM21S1,1619,47,16,31,224,185,175,208,305,373,88,50,38,14
New Buildings 2,95MM21S2,1762,316,76,240,511,204,264,118,149,153,47,38,9,0
Pennyburn 1,95MM22S1,1219,91,17,74,312,166,157,118,142,139,69,48,21,25
Pennyburn 2,95MM22S2,1253,177,33,144,443,153,135,84,124,87,42,26,16,8
Rosemount,95MM23W1,2476,140,11,129,447,299,159,195,404,380,347,185,162,105
Shantallow East,95MM24W1,2503,117,42,75,278,188,171,217,412,613,448,318,130,59
Shantallow West 1,95MM25S1,1289,30,10,20,136,139,55,63,337,215,291,166,125,23
Shantallow West 2,95MM25S2,1458,25,8,17,143,160,99,140,292,303,268,208,60,28
Shantallow West 3,95MM25S3,1550,87,32,55,247,133,143,76,322,264,259,162,97,19
Shantallow West 4,95MM25S4,2057,223,63,160,488,280,251,143,234,208,206,139,67,24
Springtown 1,95MM26S1,1743,55,12,43,322,210,163,171,271,301,238,165,73,12
Springtown 2,95MM26S2,1386,158,64,94,339,156,225,132,171,124,69,40,29,12
Strand 1 (Derry LGD),95MM27S1,1945,120,8,112,244,176,123,161,296,332,342,205,137,151
Strand 2 (Derry LGD),95MM27S2,1272,135,10,125,259,141,138,97,191,114,78,37,41,119
The Diamond,95MM28W1,2269,74,12,62,343,247,134,199,438,454,333,196,137,47
Victoria (Derry LGD),95MM29W1,3408,216,31,185,649,317,282,286,663,589,372,234,138,34
Westland,95MM30W1,2083,104,13,91,208,184,188,172,362,436,411,284,127,18
Ardglass 1,95NN01S1,1448,103,22,81,274,110,236,100,250,251,120,84,36,4
Ardglass 2,95NN01S2,1686,86,16,70,360,127,434,102,198,260,112,70,42,7
Audley's Acre,95NN02W1,2211,207,68,139,731,276,239,149,250,257,101,68,33,1
Ballymaglave 1,95NN03S1,1319,103,27,76,301,159,193,88,201,209,62,37,25,3
Ballymaglave 2,95NN03S2,1481,138,32,106,297,156,197,150,254,214,67,29,38,8
Ballymote,95NN04W1,2861,140,15,125,519,295,281,224,562,545,259,188,71,36
Ballynahinch East,95NN05W1,2472,149,36,113,392,346,405,231,375,412,135,88,47,27
Castlewellan 1,95NN06S1,1095,46,6,40,178,79,201,110,192,191,91,62,29,7
Castlewellan 2,95NN06S2,2355,184,61,123,521,191,498,189,321,311,132,91,41,8
Cathedral 1,95NN07S1,1687,72,19,53,423,218,208,119,273,222,114,75,39,38
Cathedral 2,95NN07S2,1541,41,1,40,379,152,171,120,238,313,117,93,24,10
Crossgar 1,95NN08S1,1501,146,22,124,342,176,318,119,163,187,45,31,14,5
Crossgar 2,95NN08S2,1768,274,55,219,401,158,360,123,184,206,57,34,23,5
Derryboy 1,95NN09S1,1684,248,40,208,436,169,457,89,123,116,38,26,12,8
Derryboy 2,95NN09S2,1298,137,33,104,197,119,358,129,127,164,58,32,26,9
Donard 1,95NN10S1,1425,137,31,106,403,146,199,138,167,146,81,51,30,8
Donard 2,95NN10S2,1686,257,41,216,469,206,276,144,146,107,78,36,42,3
Drumaness 1,95NN11S1,1784,136,39,97,305,214,346,130,247,300,95,59,36,11
Drumaness 2,95NN11S2,2092,232,59,173,501,163,590,140,199,201,50,30,20,16
Dundrum,95NN12W1,2851,284,31,253,613,207,595,187,334,438,171,108,63,22
Dunmore,95NN13W1,3012,323,65,258,721,291,825,197,252,318,72,49,23,13
Killough 1,95NN14S1,1781,148,23,125,335,167,392,146,258,212,111,84,27,12
Killough 2,95NN14S2,1561,72,34,38,388,252,334,85,180,163,83,60,23,4
Killyleagh,95NN15W1,2944,193,79,114,515,391,384,305,503,482,152,81,71,19
Kilmore 1,95NN16S1,1545,287,70,217,378,174,397,85,113,71,29,26,3,11
Kilmore 2,95NN16S2,1693,247,22,225,418,153,430,68,155,146,64,55,9,12
Murlough,95NN17W1,2252,98,34,64,377,211,407,202,401,311,237,155,82,8
Quoile 1,95NN18S1,1179,84,20,64,302,145,114,82,174,155,121,70,51,2
Quoile 2,95NN18S2,1439,243,60,183,466,152,223,80,135,57,78,67,11,5
Saintfield 1,95NN19S1,1695,224,51,173,499,230,148,143,249,142,46,32,14,14
Saintfield 2,95NN19S2,1686,309,70,239,518,208,309,103,92,117,21,14,7,9
Seaforde,95NN20W1,2980,303,62,241,639,306,847,218,271,311,73,58,15,12
Shimna,95NN21W1,2680,288,45,243,565,248,555,198,307,321,162,118,44,36
Strangford,95NN22W1,2685,319,68,251,665,263,645,155,266,285,66,45,21,21
Tollymore 1,95NN23S1,1562,117,8,109,231,88,530,101,151,214,126,50,76,4
Tollymore 2,95NN23S2,1775,216,53,163,378,151,401,134,204,208,63,46,17,20
Altmore,95OO01W1,2546,141,46,95,320,176,760,193,311,470,167,143,24,8
Augher,95OO02W1,2166,155,46,109,357,139,664,169,235,308,134,98,36,5
Aughnacloy,95OO03W1,2621,209,68,141,372,190,608,229,392,467,149,117,32,5
Ballygawley,95OO04W1,2507,195,46,149,409,167,634,183,264,438,191,167,24,26
Ballysaggart,95OO05W1,2688,107,26,81,308,168,200,265,655,682,279,208,71,24
Benburb,95OO06W1,2860,226,54,172,449,219,789,218,315,482,145,110,35,17
Caledon,95OO07W1,2510,137,25,112,350,203,794,226,277,408,98,81,17,17
Castlecaulfield,95OO08W1,2674,260,43,217,467,179,770,174,234,459,115,88,27,16
Clogher,95OO09W1,2223,98,21,77,329,124,696,130,373,314,148,111,37,11
Coalisland North,95OO10W1,3460,192,48,144,632,266,635,226,494,577,405,340,65,33
Coalisland South,95OO11W1,2485,78,7,71,342,170,289,207,405,648,311,220,91,35
Coalisland West and Newmills,95OO12W1,2788,214,54,160,502,203,454,237,360,544,249,171,78,25
Coolhill,95OO13W1,2667,213,62,151,428,250,219,208,601,611,103,60,43,34
Donaghmore,95OO14W1,2588,251,66,185,502,166,736,165,251,390,117,80,37,10
Drumglass,95OO15W1,2353,107,33,74,316,159,260,209,483,539,221,162,59,59
Fivemiletown,95OO16W1,2114,143,40,103,315,154,432,184,346,376,147,112,35,17
Killyman,95OO17W1,2724,249,90,159,455,253,654,208,321,494,68,43,25,22
Killymeal,95OO18W1,2891,316,56,260,539,225,326,222,574,531,125,81,44,33
Moy,95OO19W1,2989,331,69,262,658,225,575,244,354,483,100,80,20,19
Moygashel,95OO20W1,2155,243,45,198,387,196,305,207,366,374,64,39,25,13
Mullaghmore,95OO21W1,2351,167,39,128,458,181,311,153,452,465,147,102,45,17
Washing Bay,95OO22W1,3102,250,85,165,525,242,823,194,345,469,222,173,49,32
Ballinamallard,95PP01W1,2586,210,63,147,501,322,546,241,331,314,101,81,20,20
Belcoo and Garrison,95PP02W1,2541,141,24,117,449,179,719,158,323,376,192,149,43,4
Belleek and Boa,95PP03W1,2512,163,33,130,332,158,668,206,355,412,214,131,83,4
Boho Cleenish and Letterbreen,95PP04W1,3171,243,73,170,584,286,908,208,410,365,143,118,25,24
Brookeborough,95PP05W1,2329,134,28,106,288,178,763,165,284,378,123,95,28,16
Castlecoole 1,95PP06S1,1953,107,21,86,344,255,177,198,424,325,112,64,48,11
Castlecoole 2,95PP06S2,1840,216,45,171,428,228,292,161,267,191,54,42,12,3
Derrygonnelly,95PP07W1,2728,223,44,179,537,234,688,265,320,278,179,144,35,4
Derrylin,95PP08W1,2678,155,50,105,413,140,649,325,335,506,136,118,18,19
Devenish,95PP09W1,1607,57,14,43,174,134,139,175,352,395,165,100,65,16
Donagh,95PP10W1,2387,142,29,113,348,124,615,221,367,392,165,119,46,13
Erne,95PP11W1,2553,207,46,161,413,266,291,247,513,386,204,157,47,26
Florence Court and Kinawley,95PP12W1,2602,179,45,134,398,175,750,246,304,360,177,135,42,13
Irvinestown,95PP13W1,2585,191,34,157,482,180,310,221,471,464,255,177,78,11
Kesh Ederney and Lack 1,95PP14S1,1555,89,14,75,211,117,410,116,220,284,104,80,24,4
Kesh Ederney and Lack 2,95PP14S2,2046,164,26,138,358,263,446,202,242,273,95,60,35,3
Lisbellaw,95PP15W1,3182,238,60,178,626,365,635,280,475,442,101,70,31,20
Lisnarrick,95PP16W1,1877,202,54,148,370,226,379,135,244,237,67,49,18,17
Lisnaskea,95PP17W1,2486,128,10,118,339,149,327,236,553,496,226,171,55,32
Maguiresbridge,95PP18W1,3117,189,58,131,463,306,795,310,451,435,158,129,29,10
Newtownbutler,95PP19W1,2502,121,36,85,323,154,534,169,387,561,229,153,76,24
Portora,95PP20W1,3103,231,33,198,677,360,408,290,513,400,195,127,68,29
Rosslea,95PP21W1,2167,91,21,70,267,146,668,86,290,426,183,153,30,10
Rossorry,95PP22W1,2442,246,53,193,478,252,316,192,470,353,115,81,34,20
Tempo,95PP23W1,2515,176,20,156,444,207,725,153,306,338,146,119,27,20
Antiville,95QQ01W1,1483,63,19,44,237,144,116,182,303,316,116,71,45,6
Ballycarry,95QQ02W1,2582,284,91,193,639,260,425,318,308,290,37,17,20,21
Ballyloran,95QQ03W1,1096,39,12,27,106,131,46,148,265,277,74,58,16,10
Blackcave,95QQ04W1,1635,63,30,33,241,204,133,203,327,344,116,78,38,4
Carncastle,95QQ05W1,2872,480,102,378,816,368,350,267,280,248,56,31,25,7
Carnlough,95QQ06W1,2005,109,30,79,253,196,404,191,362,350,129,96,33,11
Central (Larne LGD),95QQ07W1,1775,102,23,79,295,205,178,187,293,393,116,91,25,6
Craigy Hill,95QQ08W1,1455,56,17,39,191,150,73,222,349,343,66,54,12,5
Gardenmore,95QQ09W1,1846,181,34,147,384,229,214,255,236,239,97,70,27,11
Glenarm,95QQ10W1,1851,197,40,157,286,115,512,160,280,235,63,44,19,3
Glynn,95QQ11W1,2027,187,65,122,477,227,414,195,215,222,84,54,30,6
Harbour,95QQ12W1,1697,134,40,94,391,238,141,193,287,218,82,49,33,13
Island Magee,95QQ13W1,2568,256,68,188,628,385,447,266,302,245,39,21,18,0
Kilwaughter 1,95QQ14S1,3660,306,85,221,817,543,340,533,546,449,92,50,42,34
Kilwaughter 2,95QQ14S2,1770,175,56,119,277,189,496,179,166,229,46,35,11,13
Town Parks,95QQ15W1,1592,72,12,60,220,187,136,292,306,297,72,42,30,10
Aghanloo 1,95RR01S1,2491,185,56,129,558,443,308,217,404,225,116,62,54,35
Aghanloo 2,95RR01S2,1876,188,53,135,357,230,403,160,198,232,99,52,47,9
Ballykelly,95RR02W1,1751,70,23,47,243,188,311,156,299,318,157,120,37,9
Coolessan,95RR03W1,1422,36,10,26,139,103,76,131,295,330,287,200,87,25
Dungiven,95RR04W1,2022,86,19,67,270,210,395,105,235,416,265,161,104,40
Enagh 1 (Limavady LGD),95RR05S1,1275,82,18,64,286,211,167,128,179,150,56,37,19,16
Enagh 2 (Limavady LGD),95RR05S2,1194,32,11,21,149,111,97,131,230,268,158,109,49,18
Feeny,95RR06W1,2206,108,33,75,288,169,720,117,188,437,170,96,74,9
Forest,95RR07W1,2449,176,29,147,425,235,521,222,306,396,156,88,68,12
Glack,95RR08W1,2106,150,60,90,359,141,569,192,202,356,125,85,40,12
Gresteel 1,95RR09S1,2146,130,17,113,376,216,343,143,317,406,190,125,65,25
Gresteel 2,95RR09S2,1525,97,17,80,303,263,179,138,203,235,102,41,61,5
Greystone (Limavady LGD),95RR10W1,1338,32,4,28,154,85,88,98,287,320,257,173,84,17
Magilligan,95RR11W1,1803,137,30,107,277,184,398,189,205,283,115,89,26,15
Rathbrady,95RR12W1,1452,128,30,98,330,230,156,116,190,218,80,48,32,4
Roeside,95RR13W1,1367,114,21,93,229,142,143,122,196,283,137,105,32,1
The Highlands,95RR14W1,1969,131,39,92,275,199,512,142,206,338,153,104,49,13
Upper Glenshane,95RR15W1,2458,197,63,134,396,206,768,121,220,332,199,134,65,19
Ballinderry 1,95SS01S1,1920,388,69,319,448,175,502,118,128,124,37,23,14,0
Ballinderry 2,95SS01S2,2830,402,106,296,802,373,435,179,284,313,33,22,11,9
Ballymacash 1,95SS02S1,2205,248,42,206,546,354,201,189,323,211,120,75,45,13
Ballymacash 2,95SS02S2,2013,521,122,399,682,253,233,93,135,81,11,4,7,4
Ballymacbrennan 1,95SS03S1,1580,331,56,275,404,160,459,73,73,52,28,16,12,0
Ballymacbrennan 2,95SS03S2,1790,362,101,261,481,157,475,97,92,108,8,4,4,10
Ballymacoss 1,95SS04S1,2315,203,44,159,407,389,189,243,412,316,135,95,40,21
Ballymacoss 2,95SS04S2,1885,183,54,129,390,268,146,207,343,265,58,31,27,25
Ballymacoss 3,95SS04S3,3352,436,94,342,827,508,494,270,332,351,78,39,39,56
Blaris 1,95SS05S1,1572,90,17,73,317,206,152,140,279,325,55,27,28,8
Blaris 2,95SS05S2,1803,353,57,296,537,247,252,122,137,128,24,22,2,3
Collin Glen 1,95SS06S1,1565,43,6,37,229,167,159,78,283,284,293,223,70,29
Collin Glen 2,95SS06S2,2365,37,4,33,228,254,134,149,486,418,612,471,141,47
Collin Glen 3,95SS06S3,1969,24,11,13,228,182,123,136,431,364,434,348,86,47
Derryaghy 1,95SS07S1,3775,290,96,194,774,619,381,322,609,458,274,235,39,48
Derryaghy 2,95SS07S2,1697,81,29,52,279,325,285,149,258,192,93,49,44,35
Derryaghy 3,95SS07S3,3872,537,98,439,966,469,375,358,518,455,175,102,73,19
Dromara 1,95SS08S1,1934,446,91,355,553,315,293,67,102,118,32,17,15,8
Dromara 2,95SS08S2,2724,302,44,258,617,337,659,220,250,251,71,42,29,17
Drumbo 1,95SS09S1,1697,586,91,495,468,178,251,66,47,76,22,16,6,3
Drumbo 2,95SS09S2,1667,375,86,289,433,141,372,91,128,106,13,9,4,8
Dunmurry 1,95SS10S1,2199,359,55,304,656,322,197,112,257,190,78,47,31,28
Dunmurry 2,95SS10S2,2136,415,94,321,667,339,277,160,129,105,24,13,11,20
Glenavy 1,95SS11S1,2946,347,128,219,832,321,538,185,336,264,102,59,43,21
Glenavy 2,95SS11S2,2751,281,72,209,635,225,674,307,242,326,50,31,19,11
Harmony Hill,95SS12W1,3054,510,99,411,928,389,323,253,319,273,51,39,12,8
Hilden 1,95SS13S1,1528,105,21,84,273,172,121,140,288,341,79,48,31,9
Hilden 2,95SS13S2,1376,58,10,48,244,168,76,161,252,333,71,41,30,13
Hillhall 1,95SS14S1,1420,53,8,45,143,150,95,207,283,366,113,69,44,10
Hillhall 2,95SS14S2,1485,251,54,197,382,194,179,128,140,139,65,32,33,7
Hillsborough 1,95SS15S1,1793,443,75,368,512,222,190,97,137,143,34,21,13,15
Hillsborough 2,95SS15S2,1925,513,110,403,495,166,398,97,114,107,26,16,10,9
Kilwee 1,95SS16S1,1427,160,35,125,464,214,152,101,148,132,48,39,9,8
Kilwee 2,95SS16S2,1687,83,22,61,258,169,120,132,349,319,244,181,63,13
Knockmore 1,95SS17S1,2675,276,72,204,534,345,316,262,425,446,62,38,24,9
Knockmore 2,95SS17S2,1549,109,46,63,266,197,138,137,315,320,58,31,27,9
Lagan Valley 1,95SS18S1,1415,54,12,42,248,176,108,132,308,260,113,76,37,16
Lagan Valley 2,95SS18S2,1526,135,28,107,313,174,118,138,296,283,60,48,12,9
Lambeg 1,95SS19S1,1305,180,47,133,294,147,123,115,195,207,41,18,23,3
Lambeg 2,95SS19S2,1432,52,6,46,250,173,124,150,324,255,86,56,30,18
Lisnagarvey,95SS20W1,2605,341,76,265,626,427,250,262,341,299,58,42,16,1
Maghaberry 1,95SS21S1,2332,289,80,209,571,406,351,230,267,175,22,16,6,21
Maghaberry 2,95SS21S2,2382,337,65,272,537,277,544,184,233,198,65,46,19,7
Magheralave 1,95SS22S1,1603,185,38,147,544,305,117,141,171,118,22,18,4,0
Magheralave 2,95SS22S2,1642,280,45,235,474,282,149,118,168,148,15,14,1,8
Maze 1,95SS23S1,2155,510,95,415,571,244,320,144,161,160,23,12,11,22
Maze 2,95SS23S2,1658,230,27,203,325,192,266,193,168,220,57,27,30,7
Moira 1,95SS24S1,2757,603,144,459,827,381,382,149,208,156,39,35,4,12
Moira 2,95SS24S2,2317,521,79,442,632,286,232,162,237,173,48,25,23,26
Old Warren,95SS25W1,2589,77,20,57,240,202,181,297,648,642,264,149,115,38
Poleglass 1,95SS26S1,1986,49,16,33,197,267,112,151,435,395,351,269,82,29
Poleglass 2,95SS26S2,1795,136,32,104,379,286,190,154,253,268,119,72,47,10
Seymour Hill,95SS27W1,2471,188,43,145,499,284,163,254,484,454,128,76,52,17
Tonagh,95SS28W1,2557,135,18,117,391,289,195,270,542,573,140,102,38,22
Twinbrook 1,95SS29S1,1261,34,8,26,132,175,101,84,263,224,230,167,63,18
Twinbrook 2,95SS29S2,1386,19,2,17,141,175,117,114,318,284,207,142,65,11
Wallace Park 1,95SS30S1,640,105,14,91,232,81,78,34,49,42,10,9,1,9
Wallace Park 2,95SS30S2,2230,486,157,329,830,247,193,181,163,107,10,6,4,13
Ballymaguigan,95TT01W1,2748,266,65,201,473,205,772,203,301,395,115,83,32,18
Bellaghy,95TT02W1,2685,172,27,145,438,147,659,256,282,561,145,99,46,25
Castledawson 1,95TT03S1,1586,137,26,111,270,123,209,147,223,352,113,80,33,12
Castledawson 2,95TT03S2,1707,130,28,102,370,119,415,157,144,321,51,32,19,0
Draperstown,95TT04W1,2984,206,50,156,520,203,733,292,282,558,186,128,58,4
Glebe 1 (Magherafelt LGD),95TT05S1,1749,245,57,188,430,165,355,106,196,194,58,29,29,0
Glebe 2 (Magherafelt LGD),95TT05S2,1269,39,1,38,102,80,160,114,258,386,119,87,32,11
Gulladuff,95TT06W1,2723,224,60,164,498,188,742,211,294,444,112,77,35,10
Knockcloghrim,95TT07W1,2704,282,91,191,510,211,732,288,213,376,75,61,14,17
Lecumpher,95TT08W1,2724,223,80,143,459,168,892,217,235,440,83,66,17,7
Lower Glenshane 1,95TT09S1,1438,73,16,57,156,41,510,106,187,304,61,49,12,0
Lower Glenshane 2,95TT09S2,1479,148,29,119,292,65,356,138,136,257,80,61,19,7
Maghera,95TT10W1,2852,169,42,127,432,232,454,230,459,668,189,132,57,19
Swatragh 1,95TT11S1,1641,135,59,76,335,115,461,116,146,239,94,56,38,0
Swatragh 2,95TT11S2,1592,104,10,94,225,109,599,121,116,236,82,61,21,0
Tobermore,95TT12W1,2641,248,52,196,434,132,685,249,256,533,95,82,13,9
Town Parks East 1,95TT13S1,1520,154,43,111,317,134,194,137,227,244,93,56,37,20
Town Parks East 2,95TT13S2,1398,99,36,63,190,118,116,115,258,341,145,81,64,16
Town Parks West,95TT14W1,2211,216,50,166,406,212,277,161,326,484,106,87,19,23
Upperlands,95TT15W1,2480,159,53,106,324,236,621,277,283,459,103,67,36,18
Valley,95TT16W1,2691,220,46,174,396,174,794,198,260,465,162,108,54,22
Dalriada,95UU06W1,1452,135,29,106,360,165,249,119,192,128,94,55,39,10
Glenariff,95UU09W1,1688,162,49,113,295,160,406,169,229,205,47,25,22,15
Knocklayd,95UU14W1,1723,94,31,63,322,124,278,121,312,268,190,110,80,14
Armoy and Moss0Side and Moyarget,95UU99C1,2042,126,21,105,287,114,586,160,247,337,183,120,63,2
Ballylough and Bushmills,95UU99C2,1777,118,23,95,243,114,279,151,356,340,169,100,69,7
Bonamargy and Rathlin and Glenshesk,95UU99C3,1795,159,22,137,399,110,558,116,156,186,99,69,30,12
Carnmoon and Dunseverick,95UU99C4,1802,137,24,113,257,113,602,124,209,236,117,71,46,7
Glenaan and Glendun,95UU99C5,2383,191,26,165,490,235,513,158,255,348,183,116,67,10
Glentaisie and Kinbane,95UU99C6,2245,128,19,109,361,148,543,169,312,391,177,115,62,16
Annalong 1,95VV01S1,1650,97,19,78,219,131,494,123,202,287,77,59,18,20
Annalong 2,95VV01S2,1555,74,19,55,205,106,359,126,238,339,105,78,27,3
Ballybot,95VV02W1,2182,68,21,47,256,144,183,228,397,570,315,249,66,21
Bessbrook,95VV03W1,2543,98,14,84,377,221,349,200,344,651,274,194,80,29
Binnian,95VV04W1,3138,143,39,104,443,137,1103,251,376,530,136,83,53,19
Burren and Kilbroney 1,95VV05S1,1949,242,61,181,438,106,430,119,165,325,119,70,49,5
Burren and Kilbroney 2,95VV05S2,2542,451,102,349,655,188,539,109,181,333,74,53,21,12
Camlough,95VV06W1,3482,234,58,176,645,255,749,253,428,623,275,181,94,20
Clonallan 1,95VV07S1,2052,109,40,69,373,154,255,207,336,394,213,125,88,11
Clonallan 2,95VV07S2,2341,253,39,214,651,215,397,168,199,301,137,77,60,20
Creggan,95VV08W1,3052,178,36,142,554,190,703,124,323,512,456,328,128,12
Crossmaglen,95VV09W1,2665,81,28,53,320,284,465,181,306,460,544,408,136,24
Daisy Hill 1,95VV10S1,1580,52,21,31,203,130,88,144,268,439,248,159,89,8
Daisy Hill 2,95VV10S2,1575,105,16,89,209,106,166,170,279,348,179,135,44,13
Derryleckagh 1,95VV11S1,2046,198,42,156,438,177,344,157,209,376,137,81,56,10
Derryleckagh 2,95VV11S2,2380,341,52,289,647,161,387,215,222,308,72,35,37,27
Derrymore 1,95VV12S1,1652,82,18,64,246,99,229,186,299,341,150,118,32,20
Derrymore 2,95VV12S2,1523,115,21,94,228,163,178,145,187,355,135,94,41,17
Donaghmore 1,95VV13S1,2057,198,35,163,385,182,644,126,154,264,91,45,46,13
Donaghmore 2,95VV13S2,1406,182,52,130,243,83,412,110,95,221,60,36,24,0
Drumalane 1,95VV14S1,1950,190,41,149,413,127,265,176,281,316,155,97,58,27
Drumalane 2,95VV14S2,1386,140,34,106,389,119,177,89,175,187,102,64,38,8
Drumgullion 1,95VV15S1,1419,33,2,31,190,102,95,113,282,370,213,147,66,21
Drumgullion 2,95VV15S2,1665,112,26,86,427,129,238,161,235,257,81,53,28,25
Fathom,95VV16W1,3110,260,78,182,545,306,668,252,336,504,220,141,79,19
Forkhill 1,95VV17S1,2205,191,27,164,418,164,448,184,304,295,170,124,46,31
Forkhill 2,95VV17S2,2151,161,41,120,353,212,479,191,217,323,192,137,55,23
Kilkeel Central 1,95VV18S1,1862,88,30,58,252,141,481,167,322,348,53,37,16,10
Kilkeel Central 2,95VV18S2,1780,87,24,63,175,119,371,184,306,394,127,79,48,17
Kilkeel South 1,95VV19S1,1288,57,2,55,168,98,327,96,210,241,81,56,25,10
Kilkeel South 2,95VV19S2,1681,59,5,54,162,125,318,131,348,353,160,106,54,25
Lisnacree,95VV20W1,2990,154,28,126,427,173,1151,193,280,422,180,125,55,10
Mayobridge 1,95VV21S1,2302,178,26,152,454,150,642,183,200,366,118,78,40,11
Mayobridge 2,95VV21S2,1735,190,32,158,332,131,619,93,141,162,63,36,27,4
Newtownhamilton,95VV22W1,2836,131,26,105,375,198,859,230,301,502,222,183,39,18
Rostrevor,95VV23W1,2876,357,79,278,571,221,587,199,368,381,175,104,71,17
Seaview 1,95VV24S1,1479,275,53,222,406,128,291,65,117,115,74,62,12,8
Seaview 2,95VV24S2,1535,72,12,60,214,155,170,151,278,330,162,101,61,3
Silver Bridge 1,95VV25S1,1845,109,37,72,298,127,405,142,204,329,217,135,82,14
Silver Bridge 2,95VV25S2,1925,186,27,159,431,129,423,131,184,305,116,71,45,20
Spelga,95VV26W1,3583,236,41,195,515,252,1092,284,398,510,283,195,88,13
St Mary's,95VV27W1,2237,95,34,61,283,178,225,222,447,553,210,124,86,24
St Patrick's 1,95VV28S1,2157,263,38,225,446,151,234,186,355,347,156,98,58,19
St Patrick's 2,95VV28S2,1284,32,9,23,190,98,163,121,238,303,131,87,44,8
Tullyhappy,95VV29W1,3366,259,63,196,665,265,959,286,347,406,157,88,69,22
Windsor Hill 1,95VV30S1,1564,257,58,199,519,125,220,108,146,145,34,28,6,10
Windsor Hill 2,95VV30S2,1341,74,25,49,240,154,169,117,206,261,96,74,22,24
Abbey 1,95WW01S1,1372,181,38,143,307,183,77,136,224,197,52,31,21,15
Abbey 2,95WW01S2,1370,50,2,48,270,212,65,175,290,229,58,36,22,21
Ballyclare North 1,95WW02S1,1737,183,24,159,380,170,116,149,300,319,106,79,27,14
Ballyclare North 2,95WW02S2,2039,286,88,198,527,282,171,131,278,268,86,65,21,10
Ballyclare South 1,95WW03S1,1616,87,19,68,271,224,139,185,272,346,78,55,23,14
Ballyclare South 2,95WW03S2,2011,267,62,205,463,306,188,208,235,298,41,29,12,5
Ballyduff 1,95WW04S1,1611,85,25,60,370,202,105,210,293,283,54,27,27,9
Ballyduff 2,95WW04S2,1255,76,26,50,308,207,83,179,195,187,11,5,6,9
Ballyhenry 1,95WW05S1,1517,155,37,118,421,207,144,166,211,178,35,20,15,0
Ballyhenry 2,95WW05S2,1236,87,23,64,266,201,115,137,198,194,29,18,11,9
Ballynure 1,95WW06S1,1525,220,53,167,410,150,364,74,137,143,24,23,1,3
Ballynure 2,95WW06S2,1601,323,64,259,380,163,288,150,145,127,24,15,9,1
Ballyrobert 1,95WW07S1,1809,328,72,256,426,228,358,147,151,128,41,34,7,2
Ballyrobert 2,95WW07S2,2378,296,59,237,628,354,244,300,262,255,33,19,14,6
Burnthill 1,95WW08S1,1219,87,25,62,244,181,128,151,204,183,36,16,20,5
Burnthill 2,95WW08S2,1340,130,31,99,316,249,124,147,198,160,16,6,10,0
Carnmoney 1,95WW09S1,1276,66,16,50,192,151,94,155,239,254,115,96,19,10
Carnmoney 2,95WW09S2,1258,154,54,100,309,176,133,144,180,135,22,9,13,5
Cloughfern 1,95WW10S1,1718,203,24,179,401,210,141,194,244,254,42,30,12,29
Cloughfern 2,95WW10S2,1228,78,18,60,207,155,73,184,216,242,65,52,13,8
Collinbridge 1,95WW11S1,1697,234,60,174,540,285,213,90,162,131,29,18,11,13
Collinbridge 2,95WW11S2,1381,148,26,122,377,214,233,110,166,97,18,12,6,18
Coole,95WW12W1,2377,87,26,61,253,319,138,250,538,573,200,139,61,19
Doagh 1,95WW13S1,1840,308,63,245,416,283,249,173,155,201,42,23,19,13
Doagh 2,95WW13S2,1830,238,54,184,368,264,351,173,183,216,31,22,9,6
Dunanney,95WW14W1,2229,68,20,48,231,185,122,270,525,595,214,147,67,19
Glebe 1 (Newtownabbey LGD),95WW15S1,1599,166,14,152,411,257,175,139,216,195,31,18,13,9
Glebe 2 (Newtownabbey LGD),95WW15S2,1655,223,56,167,425,244,172,139,250,161,34,13,21,7
Glengormley 1,95WW16S1,1636,174,42,132,352,292,118,155,249,253,37,24,13,6
Glengormley 2,95WW16S2,1297,56,12,44,181,167,82,135,308,259,102,64,38,7
Hawthorne,95WW17W1,2266,175,46,129,425,390,186,237,416,346,78,44,34,13
Hightown,95WW18W1,2228,188,49,139,483,384,211,268,313,328,51,29,22,2
Jordanstown 1,95WW19S1,1872,220,41,179,390,318,181,233,272,221,29,25,4,8
Jordanstown 2,95WW19S2,2047,510,124,386,731,253,195,137,115,72,17,5,12,17
Jordanstown 3,95WW19S3,2306,772,195,577,777,252,208,121,102,32,22,13,9,20
Mallusk 1,95WW20S1,1827,282,78,204,446,264,255,161,165,214,29,20,9,11
Mallusk 2,95WW20S2,4574,749,182,567,1358,661,540,380,456,361,51,25,26,18
Mallusk 3,95WW20S3,1937,349,81,268,623,327,207,156,148,107,16,11,5,4
Monkstown 1,95WW21S1,1481,31,1,30,211,173,74,172,338,340,129,55,74,13
Monkstown 2,95WW21S2,2026,201,35,166,363,313,195,187,398,287,62,34,28,20
Mossley 1,95WW22S1,1414,151,47,104,306,222,117,202,193,189,27,14,13,7
Mossley 2,95WW22S2,1571,80,39,41,176,244,110,137,330,339,138,95,43,17
Rostulla 1,95WW23S1,2042,360,61,299,501,260,127,161,241,264,69,42,27,59
Rostulla 2,95WW23S2,1398,408,32,376,496,144,135,44,77,45,31,19,12,18
Valley 1,95WW24S1,1498,92,20,72,297,210,90,156,272,253,100,70,30,28
Valley 2,95WW24S2,1926,89,24,65,265,271,81,234,401,347,217,132,85,21
Whitehouse,95WW25W1,2071,59,11,48,341,243,133,245,428,441,167,123,44,14
Ballycrochan 1,95XX01S1,1730,318,113,205,623,259,195,116,128,75,16,9,7,0
Ballycrochan 2,95XX01S2,1930,357,99,258,591,349,209,151,142,98,23,16,7,10
Ballycrochan 3,95XX01S3,1599,192,45,147,455,310,151,153,200,108,28,20,8,2
Ballyholme,95XX02W1,2573,648,134,514,907,290,366,78,164,71,47,21,26,2
Ballymaconnell 1,95XX03S1,1246,132,35,97,416,216,152,89,135,71,22,12,10,13
Ballymaconnell 2,95XX03S2,1475,204,27,177,497,219,177,121,135,99,18,4,14,5
Ballymagee 1,95XX04S1,1687,280,75,205,508,300,149,137,160,114,35,7,28,4
Ballymagee 2,95XX04S2,1934,234,59,175,547,290,190,204,302,128,29,14,15,10
Bangor Castle,95XX05W1,2591,296,62,234,653,411,263,240,353,260,106,52,54,9
Bloomfield 1 (North Down LGD),95XX06S1,1724,149,28,121,365,235,120,145,340,243,105,51,54,22
Bloomfield 2 (North Down LGD),95XX06S2,2054,209,42,167,522,325,187,222,282,210,76,35,41,21
Broadway 1,95XX07S1,1420,250,43,207,442,259,120,95,135,94,25,12,13,0
Broadway 2,95XX07S2,1425,310,80,230,444,225,166,72,89,82,30,25,5,7
Bryansburn 1,95XX08S1,1323,197,55,142,453,209,143,71,140,90,17,9,8,3
Bryansburn 2,95XX08S2,1267,155,34,121,414,206,128,97,146,87,30,20,10,4
Churchill 1,95XX09S1,1280,114,25,89,343,249,111,127,171,113,42,35,7,10
Churchill 2,95XX09S2,1429,233,55,178,446,226,181,81,148,92,16,6,10,6
Clandeboye 1,95XX10S1,1777,239,57,182,356,224,175,186,254,239,91,40,51,13
Clandeboye 2,95XX10S2,1840,227,41,186,529,345,203,160,219,137,16,9,7,4
Clandeboye 3,95XX10S3,1204,65,28,37,173,176,121,157,264,183,58,29,29,7
Conlig 1,95XX11S1,2443,270,51,219,678,359,271,212,356,205,75,31,44,17
Conlig 2,95XX11S2,2269,282,60,222,677,345,277,214,258,168,40,15,25,8
Conlig 3,95XX11S3,1535,48,12,36,223,197,130,182,394,253,85,43,42,23
Craigavad,95XX12W1,2430,756,172,584,785,191,355,109,130,49,35,20,15,20
Crawfordsburn,95XX13W1,2735,739,165,574,914,357,352,97,170,66,37,25,12,3
Cultra,95XX14W1,2403,729,174,555,830,231,347,78,85,65,36,23,13,2
Dufferin,95XX15W1,2433,150,28,122,428,341,217,231,541,379,132,64,68,14
Groomsport,95XX16W1,2995,488,88,400,815,481,425,208,282,243,42,20,22,11
Harbour 1,95XX17S1,1469,116,12,104,319,242,132,152,218,175,92,36,56,23
Harbour 2,95XX17S2,1527,287,66,221,461,197,198,87,120,99,51,19,32,27
Holywood Demesne,95XX18W1,2847,620,91,529,797,411,255,163,246,247,82,56,26,26
Holywood Priory,95XX19W1,2633,796,158,638,827,297,271,114,147,109,66,39,27,6
Loughview 1,95XX20S1,1945,170,41,129,377,233,154,199,349,335,125,80,45,3
Loughview 2,95XX20S2,1160,123,56,67,469,214,44,100,103,83,20,14,6,4
Princetown,95XX21W1,2713,724,105,619,922,315,322,102,170,93,58,36,22,7
Rathgael,95XX22W1,2215,219,53,166,455,387,166,242,386,281,68,40,28,11
Silverstream,95XX23W1,3065,206,38,168,658,504,274,305,582,365,144,86,58,27
Springhill 1,95XX24S1,1336,177,32,145,408,215,136,99,176,97,28,22,6,0
Springhill 2,95XX24S2,1369,135,28,107,422,214,142,108,197,133,17,10,7,1
Whitehill,95XX25W1,2445,158,33,125,429,326,212,287,452,382,181,116,65,18
Beragh,95YY01W1,2503,252,73,179,353,255,729,190,286,299,138,99,39,1
Camowen,95YY02W1,2151,207,39,168,452,232,196,157,284,370,218,156,62,35
Clanabogan,95YY03W1,3115,312,61,251,607,222,996,209,269,347,131,87,44,22
Coolnagard,95YY04W1,3433,220,46,174,730,335,424,293,524,676,200,150,50,31
Dergmoney,95YY05W1,1630,217,28,189,340,192,186,119,215,255,102,74,28,4
Dromore,95YY06W1,2389,191,50,141,305,168,617,179,259,447,209,157,52,14
Drumnakilly,95YY07W1,2916,220,42,178,584,215,790,218,240,467,179,160,19,3
Drumquin,95YY08W1,2231,98,28,70,341,152,614,155,299,354,208,169,39,10
Drumragh,95YY09W1,2250,158,17,141,479,311,218,205,395,318,159,125,34,7
Fairy Water,95YY10W1,2140,212,56,156,433,209,638,118,200,222,105,71,34,3
Fintona,95YY11W1,2046,100,24,76,296,139,407,153,308,395,232,169,63,16
Gortin,95YY12W1,2748,265,43,222,602,184,660,218,289,399,122,79,43,9
Gortrush 1,95YY13S1,1488,156,37,119,272,156,167,103,220,299,106,93,13,9
Gortrush 2,95YY13S2,1345,76,7,69,161,132,164,124,251,271,156,113,43,10
Killyclogher 1,95YY14S1,1530,160,44,116,381,117,204,59,190,263,148,105,43,8
Killyclogher 2,95YY14S2,1564,117,27,90,344,116,253,98,212,275,138,94,44,11
Lisanelly 1,95YY15S1,364,19,11,8,84,24,60,26,57,57,36,32,4,1
Lisanelly 2,95YY15S2,1669,68,8,60,214,104,144,147,303,391,285,208,77,13
Newtownsaville,95YY16W1,2390,122,18,104,427,195,796,160,207,356,119,91,28,8
Owenkillew,95YY17W1,2350,91,15,76,317,157,820,161,207,370,221,165,56,6
Sixmilecross,95YY18W1,2374,140,27,113,383,166,811,153,202,289,217,164,53,13
Strule,95YY19W1,1479,94,12,82,232,92,182,137,298,299,136,100,36,9
Termon,95YY20W1,2330,121,14,107,478,138,789,156,171,297,176,130,46,4
Trillick,95YY21W1,2437,130,27,103,426,191,761,180,279,339,130,105,25,1
Artigarvan,95ZZ01W1,2760,185,55,130,444,230,594,247,369,484,186,105,81,21
Ballycolman,95ZZ02W1,1827,31,7,24,215,142,114,182,383,415,313,201,112,32
Castlederg,95ZZ03W1,2073,74,10,64,204,131,343,170,294,501,336,254,82,20
Clare,95ZZ04W1,2628,141,41,100,312,177,769,131,393,494,194,145,49,17
Dunnamanagh,95ZZ05W1,2187,117,33,84,287,137,556,168,212,498,198,140,58,14
East,95ZZ06W1,1714,54,13,41,143,99,96,131,292,496,384,283,101,19
Finn,95ZZ07W1,2807,103,14,89,424,208,557,201,408,598,292,166,126,16
Glenderg,95ZZ08W1,2587,65,15,50,279,148,743,180,350,476,329,220,109,17
Newtownstewart,95ZZ09W1,2243,81,20,61,315,191,401,183,329,464,261,185,76,18
North,95ZZ10W1,3169,235,82,153,612,288,456,262,492,462,333,217,116,29
Plumbridge,95ZZ11W1,2223,153,31,122,313,135,751,137,218,344,159,106,53,13
Sion Mills,95ZZ12W1,2190,91,27,64,283,151,354,166,331,579,219,147,72,16
Slievekirk,95ZZ13W1,2533,163,34,129,426,250,617,204,300,379,185,151,34,9
South 1,95ZZ14S1,1779,106,43,63,360,132,238,113,258,369,176,83,93,27
South 2,95ZZ14S2,1356,77,37,40,335,170,173,114,211,203,63,41,22,10
Victoria Bridge,95ZZ15W1,2288,109,20,89,340,146,636,163,303,377,205,160,45,9
West 1,95ZZ16S1,1908,111,21,90,381,242,276,160,253,331,141,101,40,13
West 2,95ZZ16S2,1323,77,9,68,269,101,114,115,246,271,123,78,45,7